%%%%%%%%
%P    G%
% .% . %
%  %   %
% .% . %
%     G%
%%%%%%%%
